NO ./eagle.xpm

SO ./redbrick.xpm

EA ./colorstone.xpm

WE ./FIREBLU2.xpm

F 111,222,123



111111111
1W0000001
100000001
100000001
100000001
100000001
100010001
111111111
