NO ./Makefile

SO ./Makefile

EA ./Makefile

WE ./Makefile

F 111,222,123



111111111
100000001
1000W0001
100000001
100000001
100000001
100010001
111111111
