NO ./Makefile

SO ./Makefile

EA ./Makefile

WE ./Makefile

F 111,222,123



111111111
100111001
1010W0101
101000101
100000001
100000001
111111111