NO ./eagle.xpm

SO ./redbrick.xpm

EA ./colorstone.xpm

WE ./FIREBLU2.xpm

F 255,255,255

C 0,0,0

111111111
100111001
101000101
1010W0101
100000001
1000S0001
100010001
111111111
