NO ./Makefile

SO ./Makefile

EA ./Makefile

WE ./Makefile

F 111,222,123

111111111111111
100000000000001
100000000000001
100000W00000001
100000000000001
100000111100001
101100011100001
101110011100001
100000000000001
100000000000001
111111111111111