NO ./Makefile

SO ./Makefile

EA ./Makefile

WE ./Makefile

F   111  ,  222  ,123

11111
10W01
11111
