NO ./Makefile

SO ./Makefile

EA ./Makefile

WE ./Makefile

F   111  ,  222  ,123

1111
1W01
1111