NO ./eagle.xpm

SO ./redbrick.xpm

EA ./colorstone.xpm

WE ./FIREBLU2.xpm

F 255,255,255



111111111
100111001
101000101
1010W0101
100000001
100000001
100010001
111111111
