NO ./Makefile

SO ./Makefile

EA ./Makefile

WE ./Makefile

F 111,222,123
1111111
100W001
1001001
1001001
1111111
