NO ./eagle.xpm

SO ./redbrick.xpm

EA ./colorstone.xpm

WE ./FIREBLU2.xpm

F 255,255,255

C 0,0,0

DO ./BIGDOOR.xpm

111111
1D0011
10S011
111111
