NO ./eagle.xpm

SO ./redbrick.xpm

EA ./colorstone.xpm

WE ./FIREBLU2.xpm

F 255,255,255

C 0,0,0

DO ./BIGDOOR.xpm

1111111111111111111111111
1000000000110000000000001
1011000001110000000000001
100100000000000000000000111111111
11111111101100000111000000S000001
10000000001100000111011111D111111
11110111111111011100000010001
11110111111111011101010010001
11000000110101011100000000001
10000000000000001100000010001
100000000000000011010000D0001
11000001110101011111000010I0111
11110111 1110101 101100010001
11111111 1111111 111111111111